+----------------------------------------+
|. . . . . . . . . . . . . . . . . . . . |
|. ++. +--+. +-+------------+. . . . . . |
|. ||. +--+. ++| . . . . . . . . . . . . |
|. ||. . . . .|| . ++. . . . . . . . . . |
|. ||. . . . .|+---+|. +------------+. . |
|. ||. +--+. .+----+|. +-----------+|. . |
|. ++. |++|. . . . ||. . . . . . . ||. . |
|. . . |++|. . +---++-----+. +--+. ||. . |
|. ++. +--+. . |+------++-+. +-+|. ||. . |
|. ||. . . . . ||. . . ||. . . ||. ||. . |
+. |+--+ . +---+|. . &&++. . . ++. ||. . |
+. +---+ . +----+. +--+. . @@. . . ||. . |
|. . . . . . . . . |+-+++. . . . . ||. . |
|. . . . . . ++. +-+|. ||. . . . +-+|. . |
|. . . . . . ||. +--+. |+--------++-+. . |
|. . +-------+|. . . . +++++-----||. . . |
|. . +-------+|. . . . |++++|. . ||. . . |
|. . . . . . ||. . . . |++++|. . ||. . . |
|. . . . . . ||. . . . +----+. . ||. . . |
|. . . . . . ||. . . . . . . . . ||. . . |
|. . . . . . ||. . . . . . . . . ||. . . |
+------------++------------------++------+
